4 4 3 3 4 5 1 1
2 4 3 2 4 5 1 1
2 1 2 2 4 1 4 4
1 5 3 3 4 1 4 3
1 5 5 5 1 3 3 3
4 5 5 5 2 5 5 2
3 2 5 5 2 5 1 2
1 3 1 2 2 1 1 2